{
    "grids": [
        {
            "gridID": "Pulls3",
            "gridTitle": "Pulls 3",
            "gridSize": {"height": 2, "columns": 8, "rows": 12},
            "layers": [
                {
                    "layout": [
                        "........",
                        "........",
                        "........",
                        "........",
                        "........",
                        "........",
                        "........",
                        "........",
                        "........",
                        "........",
                        "........",
                        "........"
                    ]
                },
                {
                    "layout": [
                        "        ",
                        "   T WW ",
                        "    WB  ",
                        "  T  W  ",
                        "  W  T  ",
                        "  B B   ",
                        "   B B  ",
                        "  T  W  ",
                        "  W  T  ",
                        "  BW    ",
                        " WW T   ",
                        "P       "
                    ]
                }
            ]
        }
    ]
}